NO ./textures/pentagon_wall.png
  SO ./textures/wall1.png
			WE ./textures/wall2.png
   EA ./textures/wall3.png


F 224,184,144
C 50,156,252
 
111111111111 1111111111111111111
100000000001 1100000000000000001
100000000001110000S0000011111111
100000000000001010000001
1100000000000110100000001
100000000000000000000000111111
1000000000111111000000000000011111
10000000001    100000000000001
1000000000111111000000000000001
1000000000000000000000001111111
1111111110111111111111111
        101
        101
        111


  

   

